############# ################
#...........###..............#
#............................#
#.....@.....###..............#
#...........# #########.######
#...........#         #.#
#...........#      ####.####
#######.#####      #.......#
      #.#          #.......#########
#######.####       #...............#
#..........#       #########.#######
#..........#########       #.#
#...########.......#       #.#
#..................#       #.#
##################.#    ####.#
##################.#    #....###
#..................#    #......###########
#..................#    #####............#
#....###############        #####.....x..#
#.####   #.....#                ####.....#
#.#      #.....#                   #######
#.########.....#
#..............#
#............###
#............#
#.........####
###########
